{
    "compose_ids": [
        10000, 
        134257216, 
        134268943, 
        134233952, 
        134244701, 
        134280428, 
        201390095, 
        201390094, 
        201390093, 
        201390091, 
        201390090, 
        201390089, 
        201390087, 
        201390088, 
        201390085, 
        201390086, 
        201390081, 
        201390082, 
        134245059, 
        134238903, 
        201390083, 
        201390084, 
        201390096, 
        201390097, 
        134278589, 
        134257065, 
        134264126, 
        134253385, 
        134243995, 
        134267045, 
        134275213, 
        134278629, 
        134280087, 
        134218218, 
        134262923, 
        134262215, 
        134233763, 
        134255180, 
        134224775, 
        134218624, 
        134221867, 
        134240232, 
        134257384, 
        134234796, 
        134229235, 
        134253920, 
        134275099, 
        134273700, 
        201390092, 
        134258256, 
        134276637, 
        134269247, 
        134250786, 
        134257230, 
        134250168, 
        134233693, 
        134277246, 
        201390023, 
        201390024, 
        201390001, 
        201390002, 
        134245520, 
        134253209, 
        134266379, 
        134240669, 
        134280991, 
        201385833, 
        134238764, 
        134217838, 
        134220589, 
        134240824, 
        134225795, 
        134222264, 
        134266408, 
        134278238, 
        134231458, 
        134262095, 
        134237530, 
        134255423, 
        134240327, 
        134265057, 
        134267098, 
        134278964, 
        134241560, 
        134262491, 
        134228457, 
        134259201, 
        134223892, 
        134258794, 
        134255611, 
        134242697, 
        134275762, 
        134231609, 
        134250582, 
        134237150, 
        134277380, 
        134238209, 
        134274539, 
        134241358, 
        134270877, 
        134271667, 
        134259102, 
        134279833, 
        134237376, 
        134228448, 
        134222912, 
        134270917, 
        134221221, 
        134271194, 
        134262673, 
        134253094, 
        134222026, 
        134268534, 
        134263285, 
        134254660, 
        134263362, 
        134238475, 
        134250621, 
        134278677, 
        134246431, 
        134229251, 
        134268220, 
        134240692, 
        134247437, 
        134277435, 
        134271264, 
        134265429, 
        134228689, 
        134227119, 
        134273145, 
        510000, 
        510001, 
        510002, 
        510005, 
        510006, 
        510007, 
        510008, 
        540001, 
        510009, 
        510010, 
        550001, 
        530010, 
        510011, 
        510012, 
        510013, 
        510014, 
        510015, 
        530011, 
        510020, 
        510021, 
        510022, 
        510023, 
        510016, 
        510018, 
        510019, 
        510003, 
        550002, 
        550003, 
        550004, 
        550005, 
        550006, 
        510017, 
        530001
    ], 
    "item_id_seed": 4
}